卜	lang
卝	UseOnlyAssemblyResources
卞	table_def
卟	table_base
占	table
卡	changeLangActions
卢	get_lang
卣	PlayerPrefsSetString
卤	PlayerPrefsGetString
卥	Get2LetterISOCodeFromSystemLanguage
卦	AddToDefault
卧	Translate
卨	GetLocalizationKey
卩	_Localization
卪	SelectLocalizationName
卫	GetSelectedLocalizationName
卬	GetLanguageNames
卭	AddToChangeLang
卮	RemoveFromChangeLang
卯	LoadLocalizationFileFromText
印	LocalizedResourcesLoad
危	LocalizedResourcesLoad_type
即	LoadDefaults
却	_LoadDefaultResorceFile
卵	ReadFromAssemblyResources
卶	ReadFromAssemblyDirectory
卷	ReadFromUnityResorceAsset
卸	GetStringHash
卹	FindInChangeLang
卺	VerifyString
卻	TestStr
卼	DeleteAll
卽	DeleteKey
卾	HasKey
卿	Save
厀	GetFloat
厁	GetInt
厂	GetString
厃	SetFloat
厄	SetInt
厅	SetString
历	GetStringHashAsHex
厇	ExpirationAfterMinutes
厈	expirationTime
厉	expirationTime2
厊	st_group
压	st_text
厌	IsExpired
厍	IsExpiredLevel
厎	VerifyDemoModeExpirationTime
厏	VerifyDemoModeExpirationTimeOnGUI
厐	DrawExpirationMessage
厑	VerifyDemoModeExpirationTime_GUI
厒	expirationTime3
厓	expirationTime4
厔	resources
厕	GetResourcesList
厖	GetResourceStream
厗	is2017
厘	LoadImage_bytes
厙	is_init
厚	LoadImage_2017
厛	EncodeToPNG_2017
厜	LoadImageCustom
厝	disableLocalization
厞	LoadEncryptedResourceDisbaleLocalization
原	LoadEncryptedResourceText
厠	LoadEncryptedResourceBinary
厡	LoadEncryptedResourceTexture
厢	LoadEncryptedResourceTextureEx
厣	LoadEncryptedResourceMesh
厤	LoadEncryptedResourceAssetBundle
厥	LoadEncryptedResourceAssetObject
厦	_STRING_ENCRYPT_KEY
厧	list
厨	Rnd
厩	GetDefaultEncryptPassword
厪	_DecryptStringFastInd
厫	_DecryptStringFast
厬	DecryptStringUTF8
厭	EncryptStringUTF8
厮	DecryptStringBig
厯	def_headerSize
厰	Load
厱	SerializeMeshes
厲	DeserializeMeshes
厳	WriteMesh
厴	ReadMesh
厵	WriteMeshHeader
厶	ReadMeshHeader
厷	WriteVertices
厸	ReadVertices
厹	WriteTriangleIndicies
厺	ReadTriangleIndicies
去	_DefaultEncryptPassword
厼	prefix
厽	prefix2
厾	Decrypt
县	IsEncrypted
叀	DecryptBytes
叁	Decrypt_GetMeta
卲`1	LocalizedResourcesLoad_Template
參	$current
叄	$disposing
叅	$PC
叆	$this
叇	StringLocalization
又	PlayerPrefsProtected
叉	DemoMode
及	DM
友	ResourcesTools
双	ImageConversionCustom
反	ResourcesEncryption
収	StrEncrypt
叏	BaseMeshSerializer
叐	Crypto
参	DecryptString
